11111111111111
11111101000001
10000100000101
11111101111111
10C000E000C001
11111101111111
111111C1111111
11111101111111
111111P1111111
11111111111111