11111111111111111111111111111
10001001000001000010000000011
1001C000000010000000000E00001
1110000C000000C00001000000001
100000000000010000P0000000001
10C0010000001000000C000000001
10000000000000000000000000001
10000000000010000000000000001
11111111111111111111111111111