11111111111111111111111111111
1P00B0010B0B01000010000000011
100C0B00001010000000000E00001
1100B00000000C000010000000011
10100000000001000010000000101
1100010000001000000C000000011
10C00B00000000000000000000001
10000010000010000000000000001
11111111111111111111111111110