11111111111111111111111111111
1000B0010B0B01000010000000011
1000CB00001010000000000E00001
1100B00000000C000010000000011
101000000000010000P0000000101
11C0010000001000000C000000011
10000B00000000000000000000001
10000C10000010000000000000001
11111111111111111111111111111